1111111111111111111111111111111111
10E000000000000C00000C000000000001
10100101001000001010010000C0010101
1010010010101010001001000000010101
10P00000C00C00000000000000000000C1
1111111111111111111111111111111111