1111111111111111111111111111111111
110000000000000C00000C000000000001
11110101001000001010010000C0010101
1010010010101010001001000000010101
10PE0000C00C00000000000000000000C1
1111111111111111111111111111111111