1111111111111111111111111111111111
110000000000000C00000C0000000000E1
11110101001000001010010000C0010101
1010010010101010001001000000010101
11110101001000001010010000C0010101
1010010010101010001001000000010101
11110101001000001010010000C0010101
11110101001000001010010000C0010101
1010010010101010001001000000010101
11110101001000001010010000C0010101
1010010010101010001001000000010101
1010010010101010001001000000010101
1010010010101010001001000000010101
1010010010101010001001000000010101
1010010010101010001001000000010101
1010010010101010001001000000010101
1010010010101010001001000000010101
1010010010101010001001000000010101
1010010010101010001001000000010101
1010010010101010001001000000010101
1010010010101010001001000000010101
1010010010101010001001000000010101
1010010010101010001001000000010101
1010010010101010001001000000010101
1010010010101010001001000000010101
1010010010101010001001000000010101
1010010010101010001001000000010101
1010010010101010001001000000010101
1010010010101010001001000000010101
10P00000C00C00000000000000000000C1
1111111111111111111111111111111111