111111
1000E1
1PC011
111111
111111
